W             B                                                                                                                                                                                      G
W                                                                                                                                                                                                    G
W                                                                                                                                                                                                    G
W                                                                                                                                                                                                    G
W                                                                                                                                                                                                    G
W                                                                                                                                                                                                    G
W                                                                                                                                                                                                    G
W                                                                                                                                                                                                    G
W                                                                                                                                                                                                    G
W                                                                                                                                                                                                    G
W                                                                                                                                                                                                    G
W             BB                                                                                                                                                                                     G
W            B  B                                                                                                                                                                                    G
W           B    B                                                                                                                                                                                   G
W          B      B                                                                                                                                                                                  G
W         B        B                                                                                                                                                                                 G
W        B          B                                                                                                                                                                                G
W       BBBBBBBBBBBBBB                                                                                                                                                                               G
WWWWWWWWWWWWWWWWWWWWWWWWWWWWWWWWWWWWWWWWWWWWWWWWWWWWWWWWWWWWWWWWWWWWWWWWWWWWWWWWWWWWWWWWWWWWWWWWWWWWWWWWWWWWWWWWWWWWWWWWWWWWWWWWWWWWWWWWWWWWWWWWWWWWWWWWWWWWWWWWWWWWWWWWWWWWWWWWWWWWWWWWWWWWWWWWWWWWWW
                                                                                                                                                                                                       